..............................
..............................
..............................
..............................
.......####........####.......
.......####........####.......
.......##..##....##..##.......
.......##...######...##.......
.......##.....==.....##.......
.......##.....==.....##.......
.......##.....==.....##.......
.......##.....==.....##.......
.......##.....==.....##.......
.......##.....==.....##.......
.........##...==...##.........
...........##.==.##,..........
.............####.............
..............................
..............................
..............................
..............................
..............................
..............................
..............................
..............................
..............................
..............................