..............................
..............................
..............................
..............................
..............................
.......####........####.......
.......##..##....##..##.......
.......##....####....##.......
.......##.....##.....##.......
.......##.....##.....##.......
.......##.....##.....##.......
.......##.....##.....##.......
.......##.....##.....##.......
.......##.....##.....##.......
.........##...##...##.........
...........##.##.##...........
.............$$$$.............
..............................
..............................
..............................
..............................
..............................
..............................
..............................
..............................
..............................
..............................