..............................
..............................
..............................
....==........................
....####......................
....######....................
....########..................
....##########................
....############..............
....##############............
....################..........
....#################.........
....###################.......
..............................
..............................
..............................
..............................
..............................
..............................
..............................
..............................
..............................
..............................
..............................
..............................
..............................
..............................