..............................
..............................
..............................
..............................
....##########....########$$..
....##########....######$$##..
....########$$....####$$####..
....######$$##....##$$######..
....####$$####....$$########..
....##$$######....##########..
....$$########....##########..
....##########....##########..
....##########....##########..
..............................
..............................
..............................
..............................
..............................
..............................
..............................
..............................
..............................
..............................
..............................
..............................
..............................
..............................