..............................
..............................
##########################....
..............................
..............................
....==================........
..............................
..............................
##########################....
..............................
..............................
....==================........
..............................
..............................
##########################....
..............................
..............................
..............................
..............................
..............................
..............................
..............................
..............................
..............................
..............................
..............................
..............................