..............................
..............................
...#######################....
..............................
..............................
....$$$$$$$$$$$$$$$$$$........
..............................
..............................
...#######################....
..............................
..............................
....$$$$$$$$$$$$$$$$$$........
..............................
..............................
...#######################....
..............................
..............................
..............................
..............................
..............................
..............................
..............................
..............................
..............................
..............................
..............................
..............................