..............................
..............................
..............................
..............................
..............................
.......####........####.......
.......##..##....##..##.......
.......##....####....##.......
.......##.....$$.....##.......
.......##.....$$.....##.......
.......##.....$$.....##.......
.......##.....$$.....##.......
.......##.....$$.....##.......
.......##.....$$.....##.......
.........##...$$...##.........
...........##.$$.##...........
.............####.............
..............................
..............................
..............................
..............................
..............................
..............................
..............................
..............................
..............................
..............................