..............................
..............................
...########################...
...##....................##...
...##....................##...
...##..==############==..##...
...##..##............##..##...
...##..##............##..##...
...##..##..========..##..##...
...##..##............##..##...
...##..##............##..##...
...##..################..##...
...##....................##...
...##....................##...
...########################...
..............................
..............................
..............................
..............................
..............................
..............................
..............................
..............................
..............................
..............................
..............................
..............................