..............................
..............................
........$$$$$$$$..............
......##........##............
....##............##..........
....##....####....##..........
....##..########..##..........
....##....####....##..........
....##............##..........
......##........##............
........$$$$$$$$..............
..............................
..............................
..............................
..............................
..............................
..............................
..............................
..............................
..............................
..............................
..............................
..............................
..............................
..............................
..............................
..............................