..............................
..............................
..............................
..............................
....##########....##########..
....##########....##########..
....##########....##########..
....##########....##########..
....##########....==########..
....##########....##########..
....==########....##########..
....##########....##########..
....##########....##########..
..............................
..............................
..............................
..............................
..............................
..............................
..............................
..............................
..............................
..............................
..............................
..............................
..............................
..............................