..............................
..............................
##########################....
..............................
..............................
....$$$$$$$$$$$$$$$$$$........
..............................
..............................
##########################....
..............................
..............................
....$$$$$$$$$$$$$$$$$$........
..............................
..............................
##########################....
..............................
..............................
..............................
..............................
..............................
..............................
..............................
..............................
..............................
..............................
..............................
..............................