..............................
..............................
........########..............
......##........##............
....##............##..........
....##....####....##..........
....##..########..##..........
....##....####....##..........
....##............##..........
......##........##............
........########..............
..............................
..............................
..............................
..............................
..............................
..............................
..............................
..............................
..............................
..............................
..............................
..............................
..............................
..............................
..............................
..............................