..............................
..............................
...########################...
...##....................##...
...##....................##...
...##..################..##...
...##..##............##..##...
...##..##............##..##...
...##..##..########..##..##...
...##..##............##..##...
...##..##............##..##...
...##..################..##...
...##....................##...
...##....................##...
...$$$$$$$$$$$$$$$$$$$$$$$$...
..............................
..............................
..............................
..............................
..............................
..............................
..............................
..............................
..............................
..............................
..............................
..............................